10 8
+-+-+-+-+-+-+-+-+-+-+
|*      |           |
+ +-+-+ +     +-+ + +
|   |         |X  | |
+-+ + +-+     +-+-+ +
|       |     |     |
+-+-+-+-+ + + +-+   +
|         | |   |   |
+ +-+-+ +-+ +-+ +   +
| |       | |   |   |
+ + +-+-+ + + +-+   +
| |   | | | |   |   |
+ +-+ + +-+ +-+ +   +
| |       | |   |   |
+ +-+-+-+-+ + +-+   +
|                   |
+-+-+-+-+-+-+-+-+-+-+
