7 5
+-+-+-+-+-+-+-+
|*|   | | |   |
+ +-+ + + +-+ +
|   |   |     |
+ + + +-+ +-+ +
| |   |     | |
+ +-+-+ +-+-+ +
|       |     |
+-+ + +-+-+ +-+
|   |     |  X|
+-+-+-+-+-+-+-+
